+ + + + + + + + + + + + + + + + + + + + + + + + + + + + + + + + + + + + +
+ . . . . . . . . . . + . . . . . . . . . . . . . . . . . . . . . . . . +
+ . . . . . . . . . . + . . . . . . . . . . . . . . . . . . . . . . . . +
+ . . . . . . . . . . + . . . . . . . . . . . . . . . . . . . . . . . . +
+ . . . . . . . . . . . . . . . . . . . . . . . . . . . . . . . . . . . +
+ . . . . . . . . . . . . . . . . . . . . . . . . . . . . . . . . . . . +
+ . . . . . . . . . . . . . . . . . . . . . . . . . . . . . . . . . . . +
+ . . . . . . . . . . . . . . . . . . . . . . . . . . . . . . . . . . . +
+ . . . . . . . . . . . . . . . . . . . . . . . . . . . . . . . . . . . +
+ . . . . . . . . . . + . . . . . . . . . . . . . . . . . . . . . . . . +
+ . . . . . . . . . . . . . . . . . . . . . . . . . . . . . . . . . . . +
+ . . . . . . . . . . . . . . . . . . . . . . . . . . s . . . . . . . . +
+ . . . . . . . . . . . . . . . . . . . . . . . . . . . . . . . . . . . +
+ . . . . . . . . . . . . . . . . . . . . . . . . . . . . . . . . . . . +
+ . . . . . . . . . . . . . . . . . . . . . . . . . . . . . . . . . . . +
+ . . . . . . . . . . . . . . . . . . . . . . . . . . . . . . . . . . . +
+ . . . . . . . . . . . . . . . . . . . . . . . . . . . . . . . . . . . +
+ . . . . . . . . . . . . . . . . . . . . . . . . . . . . . . . . . . . +
+ . . . . . . . . . . . . . . . . . . . . . . . . . . . . . . . . . . . +
+ . . . . . . . . . . . . . . . . . . . . . . . . . . . . . . . . . . . +
+ + + + + + + + + + + + + + + + + + + + + + + + + + + + + + + + + + + + +
