+ + + + + + + + + + + + + ^ ^ ^ ^ ^ ^ ^ ^ ^ ^ ^ ^ ^ ^ ^ ^ ^ ^ ^ ^ ^ ^ ^
+ . . . + . . . . . . . + ^ ^ ^ ^ ^ ^ ^ ^ ^ ^ ^ ^ ^ ^ ^ ^ ^ ^ ^ ^ ^ ^ ^
. . + . . . + . . . . . + ^ ^ ^ ^ ^ ^ ^ ^ ^ ^ ^ ^ ^ ^ ^ ^ ^ ^ ^ ^ ^ ^ ^
+ + + + + + + + + + + . + ^ ^ ^ ^ ^ ^ ^ ^ ^ ^ ^ ^ ^ ^ ^ ^ ^ ^ ^ ^ ^ ^ ^
+ . . . . . . . . . . . + ^ ^ ^ ^ ^ ^ ^ ^ ^ ^ ^ ^ ^ ^ ^ ^ ^ ^ ^ ^ ^ ^ ^
+ . . . . . . . . . . . + ^ ^ ^ ^ ^ ^ ^ ^ ^ ^ ^ ^ ^ ^ ^ ^ ^ ^ ^ ^ ^ ^ ^
+ + + + + + + + + + + + + ^ ^ ^ ^ ^ ^ ^ ^ ^ ^ ^ ^ ^ ^ ^ ^ ^ ^ ^ ^ ^ ^ ^
^ ^ ^ ^ ^ ^ ^ ^ ^ ^ ^ ^ ^ ^ ^ ^ ^ ^ ^ ^ ^ ^ ^ ^ ^ ^ ^ ^ ^ ^ ^ ^ ^ ^ ^ ^
^ ^ ^ ^ ^ ^ ^ ^ ^ ^ ^ ^ ^ ^ ^ ^ ^ ^ ^ ^ ^ ^ ^ ^ ^ ^ ^ ^ ^ ^ ^ ^ ^ ^ ^ ^
^ ^ ^ ^ ^ ^ ^ ^ ^ ^ ^ ^ ^ ^ ^ ^ ^ ^ ^ ^ ^ ^ ^ ^ ^ ^ ^ ^ ^ ^ ^ ^ ^ ^ ^ ^
^ ^ ^ ^ ^ ^ ^ ^ ^ ^ ^ ^ ^ ^ ^ ^ ^ ^ ^ ^ ^ ^ ^ + + + + + + + + + + + + +
+ + + + + + + + + + + + + ^ ^ ^ ^ ^ ^ ^ ^ ^ ^ + . . + . + . + . + . + +
+ . . . . . . . . . + . + ^ ^ ^ ^ ^ ^ ^ ^ ^ ^ + . . . . . . . . . . . +
+ + + + + + + + + + + . + ^ ^ ^ ^ ^ ^ ^ ^ ^ ^ + + . + . + . + . + . + +
+ . . . . . . . . . + . + ^ ^ ^ ^ ^ ^ ^ ^ ^ ^ + . . . . . . . . . . . .
+ . . . . . . . . . + . + ^ ^ ^ ^ ^ ^ ^ ^ ^ ^ + + . + . + . + . + . + +
+ . . . . . . . . . . . + ^ ^ ^ ^ ^ ^ ^ ^ ^ ^ + + + + + + + + + + + + +
+ + + + + + + + + + + + + ^ ^ ^ ^ ^ ^ ^ ^ ^ ^ ^ ^ ^ ^ ^ ^ ^ ^ ^ ^ ^ ^ ^
