e:60:2:
e:22:2:
e:13:3:
e:49:3:
e:53:3:
e:73:3:
e:38:4:
e:76:4:
e:29:5:
e:15:6:
e:31:7:
e:33:7:
e:34:7:
e:35:7:
e:13:10:
e:17:10:
e:12:11:
e:14:12:
e:53:12:
e:54:12:
e:63:13:
e:78:13:
e:18:14:
e:54:14:
e:48:15:
e:13:16:
e:48:16:
e:53:16:
e:57:16:
e:59:16:
e:58:17:
e:18:18:
e:49:18:
e:57:18:
e:46:20:
e:47:20:
e:52:20:
e:54:20:
e:69:20:
e:26:21:
e:66:21:
e:20:22:
e:65:22:
e:65:23:
e:34:24:
e:63:24:
e:72:24:
e:66:25:
e:20:26:
e:62:27:
e:70:28:
e:29:29:
e:70:30:
e:24:31:
e:28:31:
e:53:31:
e:55:31:
e:39:32:
e:42:32:
e:14:34:
e:41:34:
e:43:34:
e:1:35:
e:25:35:
e:55:35:
e:66:37:
e:52:38:
e:58:38:
e:60:38:
e:26:40:
e:49:41:
e:33:43:
e:24:44:
e:55:44:
e:46:46:
e:2:49:
e:3:50:
e:16:50:
e:36:55:
e:32:58:
e:47:58:
e:32:59:
e:43:60:
e:35:61:
e:47:61:
e:30:62:
e:48:64:
e:47:65:
e:5:66:
e:65:66:
e:10:67:
e:31:67:
e:34:67:
e:38:67:
e:50:67:
e:2:68:
e:35:68:
e:47:69:
e:60:69:
e:61:69:
e:66:69:
e:2:70:
e:64:70:
e:66:70:
e:39:71:
e:43:71:
e:8:73:
e:29:73:
e:36:73:
e:60:73:
e:61:74:
e:32:75:
e:68:75:
e:41:76:
e:62:76:
e:69:76:
e:9:77:
e:32:77:
e:43:77:
e:50:77:
e:7:78:
e:6:79:
e:47:79:
e:66:79:
e:71:79:
e:72:79:
