+ + + + + + + + + + + + + + + + + + + + + + + + + + + + + + + + + + + + + + + + + + + + + + + + + + + + + + + + + + + + + + + + + + + + + + + + + + + + + + + +
+ + + + + + + + + + + + + + + + . + + + + + + + + + + + + + + + . + + + + + + + . + + + + + + + . + + + + + + + . + + + + + + + + + + + + + + + . + + + + + + +
+ + + + + + + + + + + + + . . . . . . . . . . + + + + + + + . . . . . . . . . . . . + + + + + + . . . . . . . . . . . . . . . + + + + + + + . . . . . . . . . +
+ + + + + + + + + + + + + . . . . . . . . . + + + + + + + + . . . . . . . . . . + + + + + + + + + . . . . . . . . . . . . . . . + + + + + + . . . . . . . . . +
+ + + + + + + + + + + + + . . . . . . . . . . + + + + + + . . . . . . . . . . . + + + + + + + + + + . . . . . . . . . . . . . . + + + + + + . . . . . . . . . +
+ + + + + + + + + + + + . . . . . . . . . . + + + + + + + . . . . . . . . . . + + + + + + + + + + + . . . . . . . . . . . . . . + + + + + + . . . . . . . . . +
+ + + + + + + + + + + + . . . . . . . . . . . + + + + + + . . . . . . . . . . + + + + + + + + + + + . . . . . . . . . . . + . . + + + + + + + . . . . . . . . +
+ + + + + + + + + + . . . . . + . + . . . . . + + + + + + . . . . . . . . . + + + + + + + + + + + + + . . . . . . . . . . . . . + + + + + + + . + . . . . . . +
+ + + + + + + + + . . . . + . . . . . . . . . + + + + + + . . . . . . . . + + + + + + + + + + + + + + . . . . . . . . . . . . + + + + + + + + + + + . . . . . +
+ + + + + + + . . . . . . . . . . . . + . . . + + + + + . . . . . . . . + + + + + + + + + + + + + + + . . . . . . . . . . . . + + + + + + + + + + + + . . . . +
+ + + + + + + . . . . . . . . . . . . . . . . + + + + + + . . . . . . . + + + + + + + + + + + + + + + . . . . . . . . . . . . + + + + + + + + + + + + + . . . +
+ + + + + + + . . . . . . . . . . . + . . . . + + + + + + . . . . . . . + + + + + + + + + + + + + + + . . . . . . . . . . . . + + + + + + + + + + + + + + . . +
+ + + + + + + + . . . . . + . . . . . . . . . . + + + + + + . . . . . + + + + + + + + + + + + + + + + . . . . . . . . . . . . . + + + + + + + + + + + + + . . +
+ + + + + + + + + . . . . . . + . . . . . . . . + + + + + + + . + . + + + + + + + + + + + + + + + + . . . . . . . . . . . . . . . + + + + + + + + + + + + + . +
+ + + + + + + + + + . . . . . . . . . . . . . . + + + + + + + + + + + + + + + + + + + + + + + + + . . . . . . . . . . . . . . . . . + + + + + + + + + + + + + +
+ + + + + + + + + + + . . . . . . . . . . . . . + + + + + + + + + + + + + + + + + + + + + + + + . . . . . . . . . . . . . . . . . . . + + + + + + + + + + + + +
+ + + + + + + + + + + + . . . . . . . . + . . + + + + + + + + + + + + + + + + + + + + + + + + . . . . . . . . . . . . . . . . . . . . . + + + + + + + + + + + +
+ + + + + + + + + + + + . . . . . . . . . . . + + + + + + + + + + + + + + + + + + + + + + + . . . . . . . . . . . . . . . . . . . . . . + + + + + + + + + + + +
+ + + + + + + + + + + + + . . . . . . . . . . + + + + + + + + + + + + + + + + + + + + + + + . . . . . . . . . . . . . . . . . . . . . . + + + + + + + + + + + +
+ + + + + + + + + + + + + . . . . . . . . . . + + + + + + + + + + + + + + + + + + + + + + + . . . . . . . . . . . . . . . . . . . . . . . + + + + + + + + + + +
+ + + + + + + + + + + + + + . . . . . . . . . . + + + + + + + + + + + + + + + + + + + + + + . . . . . . . . . . . . . . . . . . . . . . . . + + + + + + + + + +
+ + + + + + + + + + + + + + + . + . . . . . . . . . . + . + + + + + + + + + + + + + + + + + . . . . . . . . . . . . . . . . . . . . . . . . . + + + + + + + + +
+ + + + + + + + + + + + + + + + + + . . . . . . . . . . . . . . + + + + + + + + + + + + + + + + . . . . . . . . . . . . . . . . . . . . . . . . + + + + + + + +
+ + + + + + + + + + + + + + + + + + + . . . . . . . . . . . . . . . . + + + + + + + + + + + + + + . . . . . . . . . . . . . . . . . . . . . . . . + + + + + + +
+ . + + + + + + + + + + + + + + + + + . . . . . . . . . . . . . . . . . + + + + + + + + + + + + + + . . . . . . . . . . . . . . . . . . . . . . . . + + + + + +
. . . + + + + + + + + + + + + + + + + . . . . . . . . . . . . . . . . . . . . . . + + + + + + + + + + . . . . . . . . . . . . . . . . . . . . . . . . + + + + +
+ . . . + + + + + + + + + + + + + + + . . . . . . . . . . . . . . . . . . . . . . . + + + + + + + + + . . . . . . . . . . . . . . . . . . . . . . . . + + + + +
+ . . . . + + + + + + + + + + + + + + . . . . . . . . . . . . . . . . . . . . . . . . + + + + + + + + + . . . . . . . . . . . . . . . . . . . . . . + + + + + +
+ . . . . . + + + + + + + + + + + + + . . . . . . . . . . . . . . . . . . . . . . . . + + + + + + + + + . . . . . . . . . . . . . . . . . . . . . + + + + + + +
+ . . . . . + + + + + + + + + + + + . . . . . . . . . . . . . . . . . . . . . . . . . + + + + + + + + + + . . . . . . . . . . . . . . . . . . . + + + + + + + +
+ . . . . . . + + + + + + + + + + + . . . . . . . . . . . . . . . . . . . . . . . . . . + + + + + + + + + . . . . . . . . . . . . . . . . . . + + + + + + + + +
+ . . . . . . . . + + + + + + + + + . . . . . . . . . . . . + . + + + . . . . . . . . . + + + + + + + + + . . . . . . . . . . . . . . . . . + + + + + + + + + +
+ . . . . . . . . . + + + + + + . . . . . . . . . . . . . . + + + + + + + . . . . . . . + + + + + + + + + + . . . . . . . . . . . . . . . . + + + + + + + + + +
. . . . . . . . . . . . . . . . . . . . . . . . . . . . + + + + + + + + + . . . . . . . + + + + + + + + + + . . . . . . . . . . . . . . . + + + + + + + + + + +
+ . . . . . . . . . . . . . . . . . . . . . . . . . . . . + + + + + + + + + . . . . . . . + + + + + + + + + . . . . . . . . . . . . . . . + + + + + + + + + + +
+ . . . . . . . . . . . . . . . . . . . . . . . . . . . . + + + + + + + + + . . . . . . . + + + + + + + + + . . . . . . . . . . . . . . . + + + + + + + + + + +
+ . . . . . . . . . . + + + + + + . . . . . . . . . . . . + + + + + + + + + + . . . . . . + + + + + + + + . . . . . . . . . . . . . . . . + + + + + + + + + + +
+ . . . . . . . + + + + + + + + + + . . . . . . . . . . . + + + + + + + + + + + + . . . . + + + . + + + . . . . . . . . . . . . . . . . + + + + + + + + + + + +
+ . . . . . . + + + + + + + + + + + + . . . . . . . . . . . + + + + + + + + + + + + . . . . . . . . . . . . . . . . . . . . . . . . . . . + + + + + + + + + + +
+ . + . + + + + + + + + + + + + + + + + . . . . . . . . . . . + + + + + + + + + + + + + . . . . . . . . . . . . . . . . . . . . . . + . + + + + + + + + + + + +
+ + + + + + + + + + + + + + + + + + + + . . . . . . . . . . . . + + + + + + + + + + + + . . . . . . . . . . . . . + . . . . . + + + + + + + + + + + + + + + + +
+ + + + + + + + + + + + + + + + + + + + . . . . . . . . . . . . . + + + + + + + + + + + . . . . . . . . . . . . + + + . + + + + + + + + + + . . . + + + + + + +
+ + + + + + + + + + + + + + + + + + + + . . . . . . . . . . . . . . + + + + + + + + + + . . . . . . . . . . . + + + + + + + + + + + + + + + + . . . + + + + + +
+ + + + + + + + + + + + + + + + + + + + . . . . . . . . . . . . . . + + + + + + + + + + . . . . . . . . . . . . + + + + + + + + + + + + + + + . + . + + + + + +
+ + + + + + + + + + + + + + + + + + + + + . . . . . . . . . . . . + + + + + + + + + + + . . . . . . . . . . . . + + + + + + + + + + + + + + + + + + + + + + + +
+ + + + + + + + + + + + + + + + + + + + . . . . . . . . . . . . + + + + + + + + + + + + . . . . . . . . . . . + + + + + + + + + + + + + + + + + + + + + + + + +
+ + + + + + + + + + + + + + + + + + + + . . . . . . . . . . . + + + + + + + + + + + + + + . . . . . . . . . . + + + + + + + + + + + + + + + + + + + + + + + + +
+ . . . + + + + + + + + + + + + . + . . . . . . . . . . . . + + + + + + + + + + + + + + + . + . . . + . . . + + + + + + + + + + + + + + + + + + + + + + + + + +
+ . . . . . + + + + + + + + + . . . . . . . . . . + . . . + + + + + + + + + + + + + + + + + + + + + . + + + + + + + + + + + + + + + + + + + + + + + + + + + + +
. . . . . . + + . + + + . + . . . . . . . . . + + + + + + + + + + + + + + + + + + + + + + + + + + + + + + + + + + + + + + + + + . . + + + + + + + + + + + + + +
+ . . . . . . . + + + + + . . . . . . . . . + + + + + + + + + + + + + + + + + + + + + + + + + + + + + + + + + + + + + + + + + . . . + + + + + + + + + + + + + +
+ . . . . . . . + + + + + . . . . . . . . . + + + + + + + + + + + + + + + + + + + + + + + + + + + + + + + + + + + + + + + + + + + . + + + + + + + + + + + + + +
+ . . . . . . + + + + + + + . . . . . . . + + + + + + + + + + + + + + + + + + + + + + + + + + + + + + + + + + + + + + + + + + + + + + + + + + + + + + + + + + +
+ . . . . . . + + + + + + + . . . . . . + + + + + + + + + + + + + + + + . + + + + + + + + + + + + + + + + + + + + + + + + + + + + + + + + + + + + + + + + + + +
+ . . . . + + + + + + + + + + + + + + + + + + + + + + + + + + + + + + + + + + + + + + + + + + + + + + + + + + + + + + + + + + + + + + + + + + + + + + + + + + +
+ . + . + + + + + + + + + + + + + + + + + + + + + + + + + + . + . . . . . + . + + + + + + + . + + + + + + + + + + + + + + + + + + + + + + + + + + + + + + + + +
+ + + + + + + + + + + + + + + + + + + + + + + + + + + + + + . . . . . . . . . . + + + + + + + . . . + + + + + + + + + + + + + + + + + + + + + + + + + + + + + +
+ + + + + + + + + + + + + + + + + + + + + + + + + + + + + + . . . . . . . . . . . . + + . . . . . . . + + + + + + + + + + + + + + + + + + + + + + + + + + + + +
+ + + + + + + + + + + + + + + + + + + + + + + + + + + + + . . . . . . . . . . . . . . . . . . . . . . + + + + + + + + + + + + + + + + + + + + + + + + + + + + +
+ + + + + + + + + + + + + + + + + + + + + + + + + + + + + . . . . . . . . . . . . . . . . . . . . . . + + + + + + + + + + + + + + + + + + + + + + + + + + + + +
+ + + + + + + + + + + + + + + + + + + + + + + + + + + + + . . . . . . . . . . . . . . . . . . . . . . + + + + + + + + + + + + + + + + + + + + + + + + + + + + +
+ + + + + + + + + + + + + + + + + + + + + + + + + + + + . . . . . . . . . . . . . . . . . . . . . . . + + + + + + + + + + + + + + + + + + + + + + + + + + + + +
+ + + + + + + + + + + + + + + + + + + + + + + + + + + + . . . . . . . . . . . . . . . . . . . . . . . + + + + + + + + + + + + + + + + + + + + + + + + + + + + +
+ + . + + + + + + + + + + + + + + + + + + + + + + + + + . . . . . . . . . . . . . . + . . . . . . . + + + + + + + + + + + + . + . . . + + + + + + + + + + + + +
+ . . . + + + + + + + + + + + . . . + + + + + + + + + + . . . . . . . . . . . . + + + + . . . . . . . + + + + + + + + + + + + . . . . + + + + + + + + + + + + +
. . . . . + . . . . + + . + . . . . . + + + + + + + + . . . . . . . . . . . . + + + + + + . . . . . + + + + + + + + + + + + . . . . . + + + + + + + + + + + + +
+ . . . . . . . . . . . . . . . . . . . + + + + + + + . . . . . . . . . . . . + + + + + + . . . . . . + + + + + + + + + + + . . . . . . + + + + + + + + + + + +
+ . . . . . . . . . . . . . . . . . . . + + + + + + + . . . . . . . . . . . . . + + + + . . . . . . . + + + + + + + + + + + . . . . . . . + + + + + + + + + + +
+ . . . . . . . . . . . . . . . . . . + + + + + + + + . . . . . . . . . . . . . . + + . . . . . . . . . + + + + + + + + + . . . . . . . . + + + + + + + + + + +
+ . . . . . . . . . . . . . . . + . . + + + + + + + + . . . . . . . . . . . . . . + . . . . . . . . . . . + + + + + + + . . . . . . . . . + + + + + + + + + + +
+ . . . . . . . . . . . . . . + + + + + + + + + + + + . . . . . . . . . . . . . . . . . . . . . . . . . . + + + + + + + + . . . . . . . . . . . + + + + + + + +
+ . + . . . . . . . . . . . + + + + + + + + + + + + + + . . . . . . . . . . . . . . . . . . . . . . . . . . . + + + . + . . . . . . . . . . . . . + . + + + + +
+ + + . . . . . . . . . . . + + + + + + + + + + + + + + . . . . . . . . . . . . . . . . . . . . . . . . . . . . . . + . . . . . . . . . . . . . . . . + + + + +
+ + + . . . . . . . . . . + + + + + + + + + + + + + + + . . . . . . . . . . . . + . . . . . . . . . . . . . . . . . . . . . . . . . . . . . . . . . . + + + + +
+ + + + . . . . . . . . . + + + + + + + + + + + + + + + . . . . . . . . . . . . . . . . . . . . . . . . . . . . . . . . . . . . . . . . . . . . . . . . . + + +
+ + + + . . . . . . . . . + + + + + + + + + + + + + + + + . . . . . . . . . . . . . . . . . . . . . . . . . . . . . . . . . . . . . . . . . . . . . . . . + + +
+ + + + . . . . . . . . . + + + + + + + + + + + + + + + + . . . . . . . . . . . . . . . . . . . . . . . . . . . . . . . . . . . . . . . . . . . . . . . . . + +
+ + + + . . . . . . . . . + + + + + + + + + + + + + + + + . . . . . . . . . . . . . . . . . . . . . . . . . . . . . . . . . . . . . . . . . . . . . . . . . . +
+ + + + . . . . . . . . . . + + + + + + + + + + + + + + + + . . . . . . . . . . . . . . . . . . . . . . . . . . . . . . . . . . . . . . . . . . . . . . . . . +
+ + + + . . . . . . . . . . + + + + + + + + + + + + + + + + . . . . . . . . . . . . . . . . . . . . . . . . . . . . . . . . . . . . . . . . . . . . . . . . . +
+ + + + + + + + + + + + + + + + + + + + + + + + + + + + + + + + + + + + + + + + + + + + + + + + + + + + + + + + + + + + + + + + + + + + + + + + + + + + + + + +
