^ ^ + + ^ ^ ^ ^ + + ^ ^
^ + . . + ^ ^ + . . + ^
+ . . . . + + . . . . +
+ . . . . . . . . . . +
+ . . . . . . . . . . +
^ + . . . . . . . . + ^
^ + . . . . . . . . + ^
^ ^ + . . . . . . + ^ ^
^ ^ ^ + . . . . + ^ ^ ^
^ ^ ^ ^ + . . + ^ ^ ^ ^
^ ^ ^ ^ ^ + + ^ ^ ^ ^ ^
