+ + + + + + + + + + + + + + + + + + + + + + + + + + + + + + + + + +
+ . . . . . . . . . + . . + . . . . . . . . . . . . . . . . . . + +
+ . . . . . . . . . + . . + + + . . . . . . . . . . . . . . . . + +
+ . . . . . . . . . . . . . . . . . . . . . . . . . . . . . . . . +
+ . . . . . . . . . + . . + + + . . . . . . . . . . . . . . . . + +
+ . . . . . . . . . + . . + . . . . . . . . . . . . . . . . . . + +
+ + + + + + + + + + + + + + + + + + + + + + + + + + + + + + + + + +
