+ + + + + + + + + +
+ . + . . . . . . +
+ . + + + + + + . +
+ . . . . . . . . +
+ + + + + + + + + +
+ . . . . . + . . +
+ . . + + + + . . +
+ . . + . . . . . +
+ . . + . . . . . +
+ + + + . + + + + +
